1 1 1 1 1 1 1
1 P 0 S 0 0 1
1 0 1 S 1 0 1
1 S S S S S 1
1 1 1 1 1 1 1